*******************
*X*XXXXXXX*X*XXX*XX
*X*******X*X***X***
*X*XXXXX*XXX*XXXXX*
*X*****X***X*****X*
*XXXXXXXXXXX*XXX*X*
***********X***X*X*
*XXXXXXXXX*XXX*XXXX
*********X***X*****
*XXX*XXX*XXXXXXXXX*
***X***X*********X*
*XXX*XXX*X*XXXXXXX*
***X***X*X*******X*
*X*XXX*X*X*X*X*XXX*
*X***X*X*X*X*X***X*
*XXX*XXX*XXX*XXXXXX
***X***X***X*******
*X*X*X*XXXXX*X*XXX*
*X*X*X*****X*X***X*